//input your maze in this file, can be any maze

**** *****
*       * 
**** * ***
*  4*    *
*** *****
*       *
***2 ****
*       *
**** ****
